¦¦¦¦¦¦¦¦¦¦¦¦¦¦¦¦¦¦¦¦¦¦¦¦¦¦¦¦¦¦¦¦¦¦¦¦¦¦¦¦¦¦¦¦¦¦¦¦¦¦¦¦¦¦¦¦¦¦¦¦¦¦¦¦¦
¦                                                               ¦
¦                                                               ¦
¦  P                                                            ¦
¦                                                               ¦
¦               #                                               ¦
¦      M    D                                                   ¦
¦                                                               ¦
¦                                                               ¦
¦                                                               ¦
¦                                                               ¦
¦                                                               ¦
¦                                                               ¦
¦                                                               ¦
¦                                                               ¦
¦                                                               ¦
¦                                                               ¦
¦                                                               ¦
¦                                                               ¦
¦                                                               ¦
¦                                                               ¦
¦                                                               ¦
¦                                                               ¦
¦                                                               ¦
¦                                                               ¦
¦                                                               ¦
¦                                                               ¦
¦                                                               ¦
¦                                                               ¦
¦                                                               ¦
¦                                                               ¦
¦¦¦¦¦¦¦¦¦¦¦¦¦¦¦¦¦¦¦¦¦¦¦¦¦¦¦¦¦¦¦¦¦¦¦¦¦¦¦¦¦¦¦¦¦¦¦¦¦¦¦¦¦¦¦¦¦¦¦¦¦¦¦¦¦